.........+
.....^^^^^
XXXX.XXXXX
..........
...^^.....
...^^XXX.X
..........
...^^.X...
^^^^^.X...
@.....X...