^^^^^^^..+
^........^
^........^
^........^
^........^
^........^
^........^
^........^
.........^
@^^^^^^^^^