.........+
..^^^^^^..
..^^^^^^..
..^^^^^^..
..^^^^^^..
..XXXXXX..
..XXXXXX..
..XXXXXX..
..........
@.........